1 12 3 4 5 6 6 6 7 4 5 6 6 6 7 4 5 6 6 8 9 4 10 2
1 12 13 14 15 16 17 18 19 14 20 21 22 23 24 14 25 26 27 26 13 14 25 2
1 30 31 32 33 35 35 36 37 32 38 39 40 41 42 32 43 44 45 46 47 32 48 2
1 50 50 50 50 50 50 50 50 50 50 50 50 50 50 50 50 50 50 50 50 50 50 2
1 51 51 51 51 51 51 51 51 51 51 51 51 51 51 51 51 51 51 51 51 51 51 2
1 52 52 52 52 52 52 52 52 52 52 52 52 52 52 52 52 52 52 52 52 52 52 2
1 53 53 53 53 53 53 53 53 53 53 53 53 53 53 53 53 53 53 53 53 53 53 2 
1 54 54 54 54 54 54 54 54 54 54 54 54 54 54 54 54 54 54 54 54 54 54 2 
1 55 55 55 55 55 55 55 55 55 55 55 55 55 55 55 55 55 55 55 55 55 55 2
1 55 55 55 55 55 55 55 55 55 55 55 55 55 55 55 55 55 55 55 55 55 55 2
34 34 34 34 34 34 34 34 34 34 34 34 34 34 34 34 34 34 34 34 34 34 34 34
68 57 58 59 60 61 56 57 58 59 60 61 56 57 58 59 60 61 56 57 58 59 60 69
62 63 64 65 66 67 62 63 64 65 66 67 62 63 64 65 66 67 62 63 64 65 66 67


